,id,seasonGoals_home,seasonGoals_away,seasonConceded_away,seasonConceded_home,seasonGoals,points,seasonConceded,seasonGoalDifference,seasonWins_home,seasonWins_away,seasonWins_overall,seasonDraws_home,seasonDraws_away,seasonDraws_overall,seasonLosses_away,seasonLosses_overall,seasonLosses_home,matchesPlayed,name,country,cleanName,shortHand,url,seasonURL_overall,seasonURL_home,seasonURL_away,position,zone,corrections,wdl_record,points_original
0,3143,48,48,31,17,96,92,48,48,15,12,27,5,6,11,5,8,3,46,Stockport County FC,,Stockport County,stockport-county-fc,/clubs/stockport-county-fc-3143,/clubs/stockport-county-fc-3143,/clubs/stockport-county-fc-3143,/clubs/stockport-county-fc-3143,1,"{'name': 'Promotion', 'number': 1}",0,lldwldwwwwwwwwwwwwlddwwddlwwdwllddwddwwwwwwwwl,
1,1837,62,27,27,25,89,88,52,37,17,9,26,3,7,10,7,10,3,46,Wrexham FC,,Wrexham,wrexham-fc,/clubs/wrexham-fc-1837,/clubs/wrexham-fc-1837,/clubs/wrexham-fc-1837,/clubs/wrexham-fc-1837,2,"{'name': 'Promotion', 'number': 1}",0,ldwddwwwlddwwdwwwlwdwwwlwwlllwwdldwwdlwwlwwwww,
2,267,43,47,25,22,90,86,47,43,13,11,24,7,7,14,5,8,3,46,Mansfield Town FC,,Mansfield Town,mansfield-town-fc,/clubs/mansfield-town-fc-267,/clubs/mansfield-town-fc-267,/clubs/mansfield-town-fc-267,/clubs/mansfield-town-fc-267,3,"{'name': 'Promotion', 'number': 1}",0,dwddwdwdwdddwwwwwldwwwdwlddlwwwlwwlwlwdllwwwwd,
3,227,48,35,41,27,83,78,68,15,14,9,23,5,4,9,10,14,4,46,Milton Keynes Dons FC,,Milton Keynes Dons,milton-keynes-dons-fc,/clubs/milton-keynes-dons-fc-227,/clubs/milton-keynes-dons-fc-227,/clubs/milton-keynes-dons-fc-227,/clubs/milton-keynes-dons-fc-227,4,"{'name': 'Promotion Play-off', 'number': 2}",0,wwlwwldldldldlwwdwdwwwwlwlwwlwlwdwlwwlwlwdwlwd,
4,231,38,35,38,30,73,71,68,5,14,7,21,2,6,8,10,17,7,46,Doncaster Rovers FC,,Doncaster Rovers,doncaster-rovers-fc,/clubs/doncaster-rovers-fc-231,/clubs/doncaster-rovers-fc-231,/clubs/doncaster-rovers-fc-231,/clubs/doncaster-rovers-fc-231,5,"{'name': 'Promotion Play-off', 'number': 2}",0,lldlldlwwlwlwwlwllwdllldwllldwdwwldwwwwwwwwwwd,
5,252,35,34,30,35,69,71,65,4,11,8,19,5,9,14,6,13,7,46,Crewe Alexandra FC,,Crewe Alexandra,crewe-alexandra-fc,/clubs/crewe-alexandra-fc-252,/clubs/crewe-alexandra-fc-252,/clubs/crewe-alexandra-fc-252,/clubs/crewe-alexandra-fc-252,6,"{'name': 'Promotion Play-off', 'number': 2}",0,ddwdlwwdwdwlwwlwwwdldlldwwwwldwwdwllwlddldwlld,
6,254,37,36,37,30,73,70,67,6,11,10,21,3,4,7,9,18,9,46,Crawley Town FC,,Crawley Town,crawley-town-fc,/clubs/crawley-town-fc-254,/clubs/crawley-town-fc-254,/clubs/crawley-town-fc-254,/clubs/crawley-town-fc-254,7,"{'name': 'Promotion Play-off', 'number': 2}",0,wdwlldwwwwllldlwlwlwllwlwwllldwwwlwwdwlwwllddw,
7,1833,28,34,37,19,62,69,56,6,11,7,18,8,7,15,9,13,4,46,Barrow AFC,,Barrow,barrow-afc,/clubs/barrow-afc-1833,/clubs/barrow-afc-1833,/clubs/barrow-afc-1833,/clubs/barrow-afc-1833,8,"{'name': None, 'number': -10}",0,wwdldwdlwldddwdwwwwwwwddlwdldwlllwwddwwllldlld,
8,248,29,32,31,28,61,69,59,2,9,10,19,8,4,12,9,15,6,46,Bradford City AFC,,Bradford City,bradford-city-afc,/clubs/bradford-city-afc-248,/clubs/bradford-city-afc-248,/clubs/bradford-city-afc-248,/clubs/bradford-city-afc-248,9,"{'name': None, 'number': -10}",0,lwdlwdddwllwwdllllwwwwddllddldwwwdwllllwdwwwww,
9,241,41,23,26,25,64,65,51,13,11,6,17,6,8,14,9,15,6,46,AFC Wimbledon,,AFC Wimbledon,afc-wimbledon,/clubs/afc-wimbledon-241,/clubs/afc-wimbledon-241,/clubs/afc-wimbledon-241,/clubs/afc-wimbledon-241,10,"{'name': None, 'number': -10}",0,ddwwddldwwwdldllwwlwdwlwdllwdwldllwdwwlddlwllw,
10,236,35,34,48,25,69,65,73,-4,12,6,18,6,5,11,12,17,5,46,Walsall FC,,Walsall,walsall-fc,/clubs/walsall-fc-236,/clubs/walsall-fc-236,/clubs/walsall-fc-236,/clubs/walsall-fc-236,11,"{'name': None, 'number': -10}",0,lwlddwwllwdlwddlldlwwlwwwlddldwwwwwlddlwwllwll,
11,238,25,21,34,23,46,64,57,-11,9,9,18,9,1,10,13,18,5,46,Gillingham FC,,Gillingham,gillingham-fc,/clubs/gillingham-fc-238,/clubs/gillingham-fc-238,/clubs/gillingham-fc-238,/clubs/gillingham-fc-238,12,"{'name': None, 'number': -10}",0,wwwwllwwldlwllwllwlwldlwwwdldwdldwwldldwdllwld,
12,3124,35,25,32,37,60,63,69,-9,9,8,17,3,9,12,6,17,11,46,Harrogate Town FC,,Harrogate Town,harrogate-town-fc,/clubs/harrogate-town-fc-3124,/clubs/harrogate-town-fc-3124,/clubs/harrogate-town-fc-3124,/clubs/harrogate-town-fc-3124,13,"{'name': None, 'number': -10}",0,wlllwlldwwlwlwllwdldwwwldwwwdwldlldlddwdwlwdld,
13,256,51,38,44,42,89,61,86,3,12,6,18,2,5,7,12,21,9,46,Notts County FC,,Notts County,notts-county-fc,/clubs/notts-county-fc-256,/clubs/notts-county-fc-256,/clubs/notts-county-fc-256,/clubs/notts-county-fc-256,14,"{'name': None, 'number': -10}",0,lwdwwwdwwlwdlwwllwlwlllwwlddllwllllldwlldwwlwl,
14,270,29,38,52,29,67,58,81,-14,8,9,17,7,3,10,11,19,8,46,Morecambe FC,,Morecambe,morecambe-fc,/clubs/morecambe-fc-270,/clubs/morecambe-fc-270,/clubs/morecambe-fc-270,/clubs/morecambe-fc-270,15,"{'name': None, 'number': -10}",0,wldwlwldwdwwwwlllldwldlddwlwwwdldwwllllwwlllld,61.0
15,259,44,23,38,32,67,57,70,-3,12,5,17,3,3,6,15,23,8,46,Tranmere Rovers FC,,Tranmere Rovers,tranmere-rovers-fc,/clubs/tranmere-rovers-fc-259,/clubs/tranmere-rovers-fc-259,/clubs/tranmere-rovers-fc-259,/clubs/tranmere-rovers-fc-259,16,"{'name': None, 'number': -10}",0,llwlllllwlwdllllwdwdwlwwwwllwdllwllwdwwlldlwwl,
16,263,34,29,44,27,63,57,71,-8,10,6,16,5,4,9,13,21,8,46,Accrington Stanley FC,,Accrington Stanley,accrington-stanley-fc,/clubs/accrington-stanley-fc-263,/clubs/accrington-stanley-fc-263,/clubs/accrington-stanley-fc-263,/clubs/accrington-stanley-fc-263,17,"{'name': None, 'number': -10}",0,wldwwllwlldwwwwllwllddwldwlwdlwdllllwdlldwlllw,
17,265,37,25,39,37,62,55,76,-14,9,7,16,6,1,7,15,23,8,46,Newport County AFC,,Newport County,newport-county-afc,/clubs/newport-county-afc-265,/clubs/newport-county-afc-265,/clubs/newport-county-afc-265,/clubs/newport-county-afc-265,18,"{'name': None, 'number': -10}",0,lwlwwdldllwlldlwdlwwldlwddwwwwlwlwllwwllllllll,
18,234,45,32,49,34,77,54,83,-6,11,3,14,5,7,12,13,20,7,46,Swindon Town FC,,Swindon Town,swindon-town-fc,/clubs/swindon-town-fc-234,/clubs/swindon-town-fc-234,/clubs/swindon-town-fc-234,/clubs/swindon-town-fc-234,19,"{'name': None, 'number': -10}",0,dwdwdwwdwllwdlllldwwllllwldlwlddldwdlllwlwwlld,
19,3141,37,29,36,46,66,51,82,-16,5,8,13,8,4,12,11,21,10,46,Salford City FC,,Salford City,salford-city-fc,/clubs/salford-city-fc-3141,/clubs/salford-city-fc-3141,/clubs/salford-city-fc-3141,/clubs/salford-city-fc-3141,20,"{'name': None, 'number': -10}",0,wdlwlllllwwwldwdlllddlllldwdwwddwldlldwwllllwd,
20,273,34,23,33,41,57,49,74,-17,9,2,11,5,11,16,10,19,9,46,Grimsby Town FC,,Grimsby Town,grimsby-town-fc,/clubs/grimsby-town-fc-273,/clubs/grimsby-town-fc-273,/clubs/grimsby-town-fc-273,/clubs/grimsby-town-fc-273,21,"{'name': None, 'number': -10}",0,dlwddwdlllwdllllwdddwdllwldldlldwddwdlldwlwlwl,
21,253,34,25,39,41,59,45,80,-21,6,5,11,7,5,12,13,23,10,46,Colchester United FC,,Colchester United,colchester-united-fc,/clubs/colchester-united-fc-253,/clubs/colchester-united-fc-253,/clubs/colchester-united-fc-253,/clubs/colchester-united-fc-253,22,"{'name': None, 'number': -10}",0,lllwlwdlwllllwwwdlllllwlllddwdldddlddwdllwwlld,
22,1827,33,26,50,34,59,42,84,-25,5,4,9,9,6,15,13,22,9,46,Sutton United FC,,Sutton United,sutton-united-fc,/clubs/sutton-united-fc-1827,/clubs/sutton-united-fc-1827,/clubs/sutton-united-fc-1827,/clubs/sutton-united-fc-1827,23,"{'name': 'Relegation', 'number': -1}",0,wllllllldllwlllwddddllwlddddldllldwldlwwwwlddd,
23,1020,19,25,40,38,44,42,78,-34,5,6,11,4,5,9,12,26,14,46,Forest Green Rovers FC,,Forest Green Rovers,forest-green-rovers-fc,/clubs/forest-green-rovers-fc-1020,/clubs/forest-green-rovers-fc-1020,/clubs/forest-green-rovers-fc-1020,/clubs/forest-green-rovers-fc-1020,24,"{'name': 'Relegation', 'number': -1}",0,lwlldwllllllwlwlddlldllddldldlwlwdlwwlllwlllww,
