,id,seasonGoals_home,seasonGoals_away,seasonConceded_away,seasonConceded_home,seasonGoals,points,seasonConceded,seasonGoalDifference,seasonWins_home,seasonWins_away,seasonWins_overall,seasonDraws_home,seasonDraws_away,seasonDraws_overall,seasonLosses_away,seasonLosses_overall,seasonLosses_home,matchesPlayed,name,country,cleanName,shortHand,url,seasonURL_overall,seasonURL_home,seasonURL_away,position,zone,corrections,wdl_record,points_original
0,93,43,33,18,14,76,73,32,44,12,10,22,5,2,7,3,3,0,32,Manchester City FC,,Manchester City,manchester-city-fc,/clubs/manchester-city-fc-93,/clubs/manchester-city-fc-93,/clubs/manchester-city-fc-93,/clubs/manchester-city-fc-93,1,"{'name': 'UEFA Champions League', 'number': 1}",0,wwwwwwllwwwdddlwdwwwwwwdwwwddwww,
1,59,38,37,11,15,75,71,26,49,12,10,22,2,3,5,3,5,2,32,Arsenal FC,,Arsenal,arsenal-fc,/clubs/arsenal-fc-59,/clubs/arsenal-fc-59,/clubs/arsenal-fc-59,/clubs/arsenal-fc-59,2,"{'name': 'UEFA Champions League', 'number': 1}",0,wwdwwdwwdwlwwwwlwdllwwwwwwwwdwwl,
2,151,43,29,16,15,72,71,31,41,13,8,21,3,5,8,2,3,1,32,Liverpool FC,,Liverpool,liverpool-fc,/clubs/liverpool-fc-151,/clubs/liverpool-fc-151,/clubs/liverpool-fc-151,/clubs/liverpool-fc-151,3,"{'name': 'UEFA Champions League', 'number': 1}",0,dwwwwwldwwdwdwwwddwwwwlwwwwdwwdl,
3,158,40,28,27,22,68,63,49,19,11,8,19,2,4,6,5,8,3,33,Aston Villa FC,,Aston Villa,aston-villa-fc,/clubs/aston-villa-fc-158,/clubs/aston-villa-fc-158,/clubs/aston-villa-fc-158,/clubs/aston-villa-fc-158,4,"{'name': 'UEFA Champions League', 'number': 1}",0,lwwlwwwdwwlwwdwwwdlwdlwlwwwldwldw,
4,92,34,31,28,21,65,60,49,16,12,6,18,0,6,6,4,8,4,32,Tottenham Hotspur FC,,Tottenham Hotspur,tottenham-hotspur-fc,/clubs/tottenham-hotspur-fc-92,/clubs/tottenham-hotspur-fc-92,/clubs/tottenham-hotspur-fc-92,/clubs/tottenham-hotspur-fc-92,5,"{'name': 'UEFA Europa League', 'number': 2}",0,dwwwwdwwwwllldlwwwlwdwdwlwwlwdwl,
5,157,43,26,32,20,69,50,52,17,11,4,15,3,2,5,9,12,3,32,Newcastle United FC,,Newcastle United,newcastle-united-fc,/clubs/newcastle-united-fc-157,/clubs/newcastle-united-fc-157,/clubs/newcastle-united-fc-157,/clubs/newcastle-united-fc-157,6,"{'name': None, 'number': -10}",0,wlllwwwdwdwlwwllwllllwdwdlwlwdww,
6,149,23,24,26,22,47,50,48,-1,8,7,15,2,3,5,7,12,5,32,Manchester United FC,,Manchester United,manchester-united-fc,/clubs/manchester-united-fc-149,/clubs/manchester-united-fc-149,/clubs/manchester-united-fc-149,/clubs/manchester-united-fc-149,7,"{'name': None, 'number': -10}",0,wlwllwlwwlwwwlwldlwldwwwwllwdldd,
7,153,26,26,33,25,52,48,58,-6,6,7,13,7,2,9,7,11,4,33,West Ham United FC,,West Ham United,west-ham-united-fc,/clubs/west-ham-united-fc-153,/clubs/west-ham-united-fc-153,/clubs/west-ham-united-fc-153,/clubs/west-ham-united-fc-153,8,"{'name': None, 'number': -10}",0,dwwwllwdlllwwdwlwwwdddlllwwddldwl,
8,152,35,26,27,25,61,47,52,9,8,5,13,4,4,8,6,10,4,31,Chelsea FC,,Chelsea,chelsea-fc,/clubs/chelsea-fc-152,/clubs/chelsea-fc-152,/clubs/chelsea-fc-152,/clubs/chelsea-fc-152,9,"{'name': None, 'number': -10}",0,dlwldlwwdlwdlwllwlwwwllwddwdwdw,
9,209,28,24,31,19,52,44,50,2,7,4,11,6,5,11,8,10,2,32,Brighton & Hove Albion FC,,Brighton & Hove Albion,brighton-hove-albion-fc,/clubs/brighton-hove-albion-fc-209,/clubs/brighton-hove-albion-fc-209,/clubs/brighton-hove-albion-fc-209,/clubs/brighton-hove-albion-fc-209,10,"{'name': None, 'number': -10}",0,wwlwwwldldddwlwdldwddlwlwdlwldld,
10,223,23,23,28,23,46,43,51,-5,7,5,12,3,4,7,8,13,5,32,Wolverhampton Wanderers FC,,Wolverhampton Wanderers,wolverhampton-wanderers-fc,/clubs/wolverhampton-wanderers-fc-223,/clubs/wolverhampton-wanderers-fc-223,/clubs/wolverhampton-wanderers-fc-223,/clubs/wolverhampton-wanderers-fc-223,11,"{'name': None, 'number': -10}",0,llwlldwdwdlwllwdlwwwdlwlwwlwldld,
11,162,29,20,35,16,49,42,51,-2,9,3,12,1,5,6,9,15,6,33,Fulham FC,,Fulham,fulham-fc,/clubs/fulham-fc-162,/clubs/fulham-fc-162,/clubs/fulham-fc-162,/clubs/fulham-fc-162,12,"{'name': None, 'number': -10}",0,wldlwdlwldllwlwwlllwlddwlwwlwdllw,
12,148,23,24,31,26,47,42,57,-10,6,5,11,6,3,9,7,12,5,32,AFC Bournemouth,,AFC Bournemouth,afc-bournemouth,/clubs/afc-bournemouth-148,/clubs/afc-bournemouth-148,/clubs/afc-bournemouth-148,/clubs/afc-bournemouth-148,13,"{'name': None, 'number': -10}",0,dllddllllwlwwdwwwwllddldlwdwwwld,
13,143,21,16,30,24,37,33,54,-17,4,4,8,4,5,9,8,15,7,32,Crystal Palace FC,,Crystal Palace,crystal-palace-fc,/clubs/crystal-palace-fc-143,/clubs/crystal-palace-fc-143,/clubs/crystal-palace-fc-143,/clubs/crystal-palace-fc-143,14,"{'name': None, 'number': -10}",0,wldwldwdllwlldllddlwlwlldwlddllw,
14,218,27,20,28,30,47,32,58,-11,5,3,8,6,2,8,11,17,6,33,Brentford FC,,Brentford,brentford-fc,/clubs/brentford-fc-218,/clubs/brentford-fc-218,/clubs/brentford-fc-218,/clubs/brentford-fc-218,15,"{'name': None, 'number': -10}",0,dwddlldlwwwllwlllllwllwllldlldddw,
15,211,25,17,33,25,42,26,58,-16,5,2,7,5,4,9,10,17,7,33,Nottingham Forest FC,,Nottingham Forest,nottingham-forest-fc,/clubs/nottingham-forest-fc-211,/clubs/nottingham-forest-fc-211,/clubs/nottingham-forest-fc-211,/clubs/nottingham-forest-fc-211,16,"{'name': None, 'number': -10}",0,lwlwdldddlwlllldllwwlldlwlllddwld,30.0
16,144,16,16,30,18,32,25,48,-16,4,5,9,4,4,8,8,15,7,32,Everton FC,,Everton,everton-fc,/clubs/everton-fc-144,/clubs/everton-fc-144,/clubs/everton-fc-144,/clubs/everton-fc-144,17,"{'name': None, 'number': -10}",0,llldlwlwlwdwlwwwwllldddlddllldwl,35.0
17,271,24,22,43,27,46,25,70,-24,4,2,6,3,4,7,11,20,9,33,Luton Town FC,,Luton Town,luton-town-fc,/clubs/luton-town-fc-271,/clubs/luton-town-fc-271,/clubs/luton-town-fc-271,/clubs/luton-town-fc-271,18,"{'name': 'Relegation', 'number': -1}",0,lllldwlldldlwlllwwldwdlllldldllwl,
18,145,17,16,31,37,33,20,68,-35,2,2,4,4,4,8,10,21,11,33,Burnley FC,,Burnley,burnley-fc,/clubs/burnley-fc-145,/clubs/burnley-fc-145,/clubs/burnley-fc-145,/clubs/burnley-fc-145,19,"{'name': 'Relegation', 'number': -1}",0,llldllwllllllwldlwlldldlllldwddld,
19,251,17,13,37,47,30,16,84,-54,2,1,3,4,3,7,12,22,10,32,Sheffield United FC,,Sheffield United,sheffield-united-fc,/clubs/sheffield-united-fc-251,/clubs/sheffield-united-fc-251,/clubs/sheffield-united-fc-251,/clubs/sheffield-united-fc-251,20,"{'name': 'Relegation', 'number': -1}",0,llldllllllwdlllwldlldllwlllddldl,
