,id,seasonGoals_home,seasonGoals_away,seasonConceded_away,seasonConceded_home,seasonGoals,points,seasonConceded,seasonGoalDifference,seasonWins_home,seasonWins_away,seasonWins_overall,seasonDraws_home,seasonDraws_away,seasonDraws_overall,seasonLosses_away,seasonLosses_overall,seasonLosses_home,matchesPlayed,name,country,cleanName,shortHand,url,seasonURL_overall,seasonURL_home,seasonURL_away,position,zone,corrections,wdl_record
0,278,28,19,12,9,47,62,21,26,9,8,17,7,4,11,5,7,2,35,CD Leganés,,Leganés,cd-leganes,/clubs/cd-leganes-278,/clubs/cd-leganes-278,/clubs/cd-leganes-278,/clubs/cd-leganes-278,1,"{'name': 'Promotion', 'number': 1}",0,lwwwwlwwldwwwwwddldddwwlddwllwwwddd
1,279,33,24,26,14,57,58,40,17,10,7,17,4,3,7,8,11,3,35,SD Eibar,,SD Eibar,sd-eibar,/clubs/sd-eibar-279,/clubs/sd-eibar-279,/clubs/sd-eibar-279,/clubs/sd-eibar-279,2,"{'name': 'Promotion', 'number': 1}",0,lwlllwwwwwdwwddlwldldwwwdwdlwlwlwlw
2,280,33,18,20,16,51,58,36,15,10,5,15,6,7,13,6,7,1,35,Reial Club Deportiu Espanyol,,RCD Espanyol,reial-club-deportiu-espanyol,/clubs/reial-club-deportiu-espanyol-280,/clubs/reial-club-deportiu-espanyol-280,/clubs/reial-club-deportiu-espanyol-280,/clubs/reial-club-deportiu-espanyol-280,3,"{'name': 'Promotion Play-off', 'number': 2}",0,dwwwwdlwwlwllddwwlddddwlwlwwddwddwd
3,297,29,12,21,10,41,58,31,10,12,5,17,4,3,7,9,11,2,35,Real Valladolid Club de Fútbol,,Real Valladolid,real-valladolid-club-de-futbol,/clubs/real-valladolid-club-de-futbol-297,/clubs/real-valladolid-club-de-futbol-297,/clubs/real-valladolid-club-de-futbol-297,/clubs/real-valladolid-club-de-futbol-297,4,"{'name': 'Promotion Play-off', 'number': 2}",0,wllldwwwwwlwlwwdwlwllldwdddwlwlwdww
4,309,30,15,17,13,45,55,30,15,10,4,14,7,6,13,7,8,1,35,Real Oviedo,,Real Oviedo,real-oviedo,/clubs/real-oviedo-309,/clubs/real-oviedo-309,/clubs/real-oviedo-309,/clubs/real-oviedo-309,5,"{'name': 'Promotion Play-off', 'number': 2}",0,ldlddllwwdwdwddwlwdwddwwdlwlwwdlwwd
5,289,26,16,20,13,42,55,33,9,10,5,15,6,4,10,8,10,2,35,Real Sporting de Gijón,,Sporting Gijón,real-sporting-de-gijon,/clubs/real-sporting-de-gijon-289,/clubs/real-sporting-de-gijon-289,/clubs/real-sporting-de-gijon-289,/clubs/real-sporting-de-gijon-289,6,"{'name': 'Promotion Play-off', 'number': 2}",0,lwlwdwdwwldwwwddwlddddwllwdlwlwllww
6,295,20,16,22,10,36,54,32,4,9,6,15,5,4,9,8,11,3,35,Elche CF,,Elche CF,elche-cf,/clubs/elche-cf-295,/clubs/elche-cf-295,/clubs/elche-cf-295,/clubs/elche-cf-295,7,"{'name': None, 'number': -10}",0,llwddwldlwdwwdwlwwlldwdwwldwwwwllld
7,4542,27,16,24,17,43,54,41,2,9,5,14,8,4,12,8,9,1,35,Racing Club de Ferrol,,Racing Club de Ferrol,racing-club-de-ferrol,/clubs/racing-club-de-ferrol-4542,/clubs/racing-club-de-ferrol-4542,/clubs/racing-club-de-ferrol-4542,/clubs/racing-club-de-ferrol-4542,8,"{'name': None, 'number': -10}",0,wdwddlwlwdldwwwddwlwwdlwdldldlwdwlw
8,319,32,23,32,18,55,53,50,5,11,4,15,2,6,8,8,12,4,35,Real Racing Club de Santander,,Racing Santander,real-racing-club-de-santander,/clubs/real-racing-club-de-santander-319,/clubs/real-racing-club-de-santander-319,/clubs/real-racing-club-de-santander-319,/clubs/real-racing-club-de-santander-319,9,"{'name': None, 'number': -10}",0,wlddwdwllwwwlllwwdddwlllwwlwdwdwwll
9,4546,28,15,35,9,43,53,44,-1,12,3,15,6,2,8,12,12,0,35,Burgos CF,,Burgos CF,burgos-cf,/clubs/burgos-cf-4546,/clubs/burgos-cf-4546,/clubs/burgos-cf-4546,/clubs/burgos-cf-4546,10,"{'name': None, 'number': -10}",0,dlwlwlwlwlwldlwddwdwdwlwlwlwwwdldlw
10,292,27,15,17,23,42,51,40,2,9,3,12,6,9,15,5,8,3,35,Levante UD,,Levante UD,levante-ud,/clubs/levante-ud-292,/clubs/levante-ud-292,/clubs/levante-ud-292,/clubs/levante-ud-292,11,"{'name': None, 'number': -10}",0,dwwdlwwddwwdldlllwdwdwddlddlwddwdwl
11,311,16,16,27,9,32,45,36,-4,9,3,12,4,5,9,10,14,4,35,CD Tenerife,,CD Tenerife,cd-tenerife,/clubs/cd-tenerife-311,/clubs/cd-tenerife-311,/clubs/cd-tenerife-311,/clubs/cd-tenerife-311,12,"{'name': None, 'number': -10}",0,wwlwwlwlwwddlllldwwldllddlwdwlddlwl
12,301,16,14,12,13,30,42,25,5,5,4,9,6,9,15,5,11,6,35,SD Huesca,,SD Huesca,sd-huesca,/clubs/sd-huesca-301,/clubs/sd-huesca-301,/clubs/sd-huesca-301,/clubs/sd-huesca-301,13,"{'name': None, 'number': -10}",0,dlddldwllldldwdwllwlwdldwddwdwdwddl
13,299,21,12,16,17,33,42,33,0,7,3,10,4,8,12,6,13,7,35,Real Zaragoza,,Real Zaragoza,real-zaragoza,/clubs/real-zaragoza-299,/clubs/real-zaragoza-299,/clubs/real-zaragoza-299,/clubs/real-zaragoza-299,14,"{'name': None, 'number': -10}",0,wwwwwdllwldlddlllwddddwdwlldllldwld
14,4516,23,18,29,21,41,42,50,-9,6,4,10,7,5,12,9,13,4,35,CD Eldense,,CD Eldense,cd-eldense,/clubs/cd-eldense-4516,/clubs/cd-eldense-4516,/clubs/cd-eldense-4516,/clubs/cd-eldense-4516,15,"{'name': None, 'number': -10}",0,wlwlddlllwddwwwdllddddwwddlwwldllll
15,302,13,14,28,16,27,40,44,-17,5,5,10,8,2,10,10,15,5,35,AD Alcorcón,,AD Alcorcón,ad-alcorcon,/clubs/ad-alcorcon-302,/clubs/ad-alcorcon-302,/clubs/ad-alcorcon-302,/clubs/ad-alcorcon-302,16,"{'name': None, 'number': -10}",0,llwddlldlwldlwldlllwwdwdlwldldlwdww
16,4507,15,16,21,24,31,39,45,-14,6,4,10,1,8,9,6,16,10,35,FC Cartagena,,FC Cartagena,fc-cartagena,/clubs/fc-cartagena-4507,/clubs/fc-cartagena-4507,/clubs/fc-cartagena-4507,/clubs/fc-cartagena-4507,17,"{'name': None, 'number': -10}",0,lllwllldldldlldddwwllwwwdwwllwdwdll
17,300,26,13,26,23,39,38,49,-10,7,2,9,4,7,11,9,15,6,35,CD Mirandés,,Mirandés,cd-mirandes,/clubs/cd-mirandes-300,/clubs/cd-mirandes-300,/clubs/cd-mirandes-300,/clubs/cd-mirandes-300,18,"{'name': None, 'number': -10}",0,wlldwllwlldwwdldwddwdddlwllllwldlld
18,4522,19,13,27,15,32,37,42,-10,6,3,9,5,5,10,9,16,7,35,SD Amorebieta,,SD Amorebieta,sd-amorebieta,/clubs/sd-amorebieta-4522,/clubs/sd-amorebieta-4522,/clubs/sd-amorebieta-4522,/clubs/sd-amorebieta-4522,19,"{'name': 'Relegation', 'number': -1}",0,ddwllwldllldlldwllldldlllwddwlwwdww
19,316,23,17,32,18,40,36,50,-10,7,1,8,7,5,12,11,15,4,35,Albacete Balompié,,Albacete Balompié,albacete-balompie,/clubs/albacete-balompie-316,/clubs/albacete-balompie-316,/clubs/albacete-balompie-316,/clubs/albacete-balompie-316,20,"{'name': 'Relegation', 'number': -1}",0,ddlwlwlwwlllddddwlwldlllddwdlllddlw
20,672363,17,10,25,17,27,35,42,-15,7,2,9,3,5,8,11,18,7,35,FC Andorra,,FC Andorra,fc-andorra,/clubs/fc-andorra-672363,/clubs/fc-andorra-672363,/clubs/fc-andorra-672363,/clubs/fc-andorra-672363,21,"{'name': 'Relegation', 'number': -1}",0,wwlllwdlllwlwllddwddlllldldwldllwwl
21,4492,20,12,33,19,32,33,52,-20,7,1,8,5,4,9,13,18,5,35,Villarreal CF II,,Villarreal II,villarreal-cf-ii,/clubs/villarreal-cf-ii-4492,/clubs/villarreal-cf-ii-4492,/clubs/villarreal-cf-ii-4492,/clubs/villarreal-cf-ii-4492,22,"{'name': 'Relegation', 'number': -1}",0,lwllddwddwllllwdlwlwdlldlwddlllllwl
