,id,seasonGoals_home,seasonGoals_away,seasonConceded_away,seasonConceded_home,seasonGoals,points,seasonConceded,seasonGoalDifference,seasonWins_home,seasonWins_away,seasonWins_overall,seasonDraws_home,seasonDraws_away,seasonDraws_overall,seasonLosses_away,seasonLosses_overall,seasonLosses_home,matchesPlayed,name,country,cleanName,shortHand,url,seasonURL_overall,seasonURL_home,seasonURL_away,position,zone,corrections,wdl_record
0,278,28,19,12,9,47,61,21,26,9,8,17,6,4,10,5,7,2,34,CD Leganés,,Leganés,cd-leganes,/clubs/cd-leganes-278,/clubs/cd-leganes-278,/clubs/cd-leganes-278,/clubs/cd-leganes-278,1,"{'name': 'Promotion', 'number': 1}",0,lwwwwlwwldwwwwwddldddwwlddwllwwwdd
1,280,33,18,20,16,51,57,36,15,10,5,15,6,6,12,6,7,1,34,Reial Club Deportiu Espanyol,,RCD Espanyol,reial-club-deportiu-espanyol,/clubs/reial-club-deportiu-espanyol-280,/clubs/reial-club-deportiu-espanyol-280,/clubs/reial-club-deportiu-espanyol-280,/clubs/reial-club-deportiu-espanyol-280,2,"{'name': 'Promotion', 'number': 1}",0,dwwwwdlwwlwllddwwlddddwlwlwwddwddw
2,279,33,22,26,14,55,55,40,15,10,6,16,4,3,7,8,11,3,34,SD Eibar,,SD Eibar,sd-eibar,/clubs/sd-eibar-279,/clubs/sd-eibar-279,/clubs/sd-eibar-279,/clubs/sd-eibar-279,3,"{'name': 'Promotion Play-off', 'number': 2}",0,lwlllwwwwwdwwddlwldldwwwdwdlwlwlwl
3,297,28,12,21,10,40,55,31,9,11,5,16,4,3,7,9,11,2,34,Real Valladolid Club de Fútbol,,Real Valladolid,real-valladolid-club-de-futbol,/clubs/real-valladolid-club-de-futbol-297,/clubs/real-valladolid-club-de-futbol-297,/clubs/real-valladolid-club-de-futbol-297,/clubs/real-valladolid-club-de-futbol-297,4,"{'name': 'Promotion Play-off', 'number': 2}",0,wllldwwwwwlwlwwdwlwllldwdddwlwlwdw
4,309,29,15,17,12,44,54,29,15,10,4,14,6,6,12,7,8,1,34,Real Oviedo,,Real Oviedo,real-oviedo,/clubs/real-oviedo-309,/clubs/real-oviedo-309,/clubs/real-oviedo-309,/clubs/real-oviedo-309,5,"{'name': 'Promotion Play-off', 'number': 2}",0,ldlddllwwdwdwddwlwdwddwwdlwlwwdlww
5,319,32,22,30,18,54,53,48,6,11,4,15,2,6,8,7,11,4,34,Real Racing Club de Santander,,Racing Santander,real-racing-club-de-santander,/clubs/real-racing-club-de-santander-319,/clubs/real-racing-club-de-santander-319,/clubs/real-racing-club-de-santander-319,/clubs/real-racing-club-de-santander-319,6,"{'name': 'Promotion Play-off', 'number': 2}",0,wlddwdwllwwwlllwwdddwlllwwlwdwdwwl
6,295,20,15,21,10,35,53,31,4,9,6,15,5,3,8,8,11,3,34,Elche CF,,Elche CF,elche-cf,/clubs/elche-cf-295,/clubs/elche-cf-295,/clubs/elche-cf-295,/clubs/elche-cf-295,7,"{'name': None, 'number': -10}",0,llwddwldlwdwwdwlwwlldwdwwldwwwwlll
7,289,25,16,20,13,41,52,33,8,9,5,14,6,4,10,8,10,2,34,Real Sporting de Gijón,,Sporting Gijón,real-sporting-de-gijon,/clubs/real-sporting-de-gijon-289,/clubs/real-sporting-de-gijon-289,/clubs/real-sporting-de-gijon-289,/clubs/real-sporting-de-gijon-289,8,"{'name': None, 'number': -10}",0,lwlwdwdwwldwwwddwlddddwllwdlwlwllw
8,292,26,15,17,21,41,51,38,3,9,3,12,6,9,15,5,7,2,34,Levante UD,,Levante UD,levante-ud,/clubs/levante-ud-292,/clubs/levante-ud-292,/clubs/levante-ud-292,/clubs/levante-ud-292,9,"{'name': None, 'number': -10}",0,dwwdlwwddwwdldlllwdwdwddlddlwddwdw
9,4542,25,16,24,16,41,51,40,1,8,5,13,8,4,12,8,9,1,34,Racing Club de Ferrol,,Racing Club de Ferrol,racing-club-de-ferrol,/clubs/racing-club-de-ferrol-4542,/clubs/racing-club-de-ferrol-4542,/clubs/racing-club-de-ferrol-4542,/clubs/racing-club-de-ferrol-4542,10,"{'name': None, 'number': -10}",0,wdwddlwlwdldwwwddwlwwdlwdldldlwdwl
10,4546,26,15,35,8,41,50,43,-2,11,3,14,6,2,8,12,12,0,34,Burgos CF,,Burgos CF,burgos-cf,/clubs/burgos-cf-4546,/clubs/burgos-cf-4546,/clubs/burgos-cf-4546,/clubs/burgos-cf-4546,11,"{'name': None, 'number': -10}",0,dlwlwlwlwlwldlwddwdwdwlwlwlwwwdldl
11,311,16,16,26,9,32,45,35,-3,9,3,12,4,5,9,9,13,4,34,CD Tenerife,,CD Tenerife,cd-tenerife,/clubs/cd-tenerife-311,/clubs/cd-tenerife-311,/clubs/cd-tenerife-311,/clubs/cd-tenerife-311,12,"{'name': None, 'number': -10}",0,wwlwwlwlwwddlllldwwldllddlwdwlddlw
12,301,16,13,10,13,29,42,23,6,5,4,9,6,9,15,4,10,6,34,SD Huesca,,SD Huesca,sd-huesca,/clubs/sd-huesca-301,/clubs/sd-huesca-301,/clubs/sd-huesca-301,/clubs/sd-huesca-301,13,"{'name': None, 'number': -10}",0,dlddldwllldldwdwllwlwdldwddwdwdwdd
13,4516,23,18,28,21,41,42,49,-8,6,4,10,7,5,12,8,12,4,34,CD Eldense,,CD Eldense,cd-eldense,/clubs/cd-eldense-4516,/clubs/cd-eldense-4516,/clubs/cd-eldense-4516,/clubs/cd-eldense-4516,14,"{'name': None, 'number': -10}",0,wlwlddlllwddwwwdllddddwwddlwwldlll
14,299,20,12,16,16,32,41,32,0,7,3,10,3,8,11,6,13,7,34,Real Zaragoza,,Real Zaragoza,real-zaragoza,/clubs/real-zaragoza-299,/clubs/real-zaragoza-299,/clubs/real-zaragoza-299,/clubs/real-zaragoza-299,15,"{'name': None, 'number': -10}",0,wwwwwdllwldlddlllwddddwdwlldllldwl
15,4507,15,16,20,24,31,39,44,-13,6,4,10,1,8,9,5,15,10,34,FC Cartagena,,FC Cartagena,fc-cartagena,/clubs/fc-cartagena-4507,/clubs/fc-cartagena-4507,/clubs/fc-cartagena-4507,/clubs/fc-cartagena-4507,16,"{'name': None, 'number': -10}",0,lllwllldldldlldddwwllwwwdwwllwdwdl
16,300,26,12,25,23,38,37,48,-10,7,2,9,4,6,10,9,15,6,34,CD Mirandés,,Mirandés,cd-mirandes,/clubs/cd-mirandes-300,/clubs/cd-mirandes-300,/clubs/cd-mirandes-300,/clubs/cd-mirandes-300,17,"{'name': None, 'number': -10}",0,wlldwllwlldwwdldwddwdddlwllllwldll
17,302,12,14,28,16,26,37,44,-18,4,5,9,8,2,10,10,15,5,34,AD Alcorcón,,AD Alcorcón,ad-alcorcon,/clubs/ad-alcorcon-302,/clubs/ad-alcorcon-302,/clubs/ad-alcorcon-302,/clubs/ad-alcorcon-302,18,"{'name': None, 'number': -10}",0,llwddlldlwldlwldlllwwdwdlwldldlwdw
18,672363,17,10,25,15,27,35,40,-13,7,2,9,3,5,8,11,17,6,34,FC Andorra,,FC Andorra,fc-andorra,/clubs/fc-andorra-672363,/clubs/fc-andorra-672363,/clubs/fc-andorra-672363,/clubs/fc-andorra-672363,19,"{'name': 'Relegation', 'number': -1}",0,wwlllwdlllwlwllddwddlllldldwldllww
19,4522,19,11,26,15,30,34,41,-11,6,2,8,5,5,10,9,16,7,34,SD Amorebieta,,SD Amorebieta,sd-amorebieta,/clubs/sd-amorebieta-4522,/clubs/sd-amorebieta-4522,/clubs/sd-amorebieta-4522,/clubs/sd-amorebieta-4522,20,"{'name': 'Relegation', 'number': -1}",0,ddwllwldllldlldwllldldlllwddwlwwdw
20,316,22,17,32,18,39,33,50,-11,6,1,7,7,5,12,11,15,4,34,Albacete Balompié,,Albacete Balompié,albacete-balompie,/clubs/albacete-balompie-316,/clubs/albacete-balompie-316,/clubs/albacete-balompie-316,/clubs/albacete-balompie-316,21,"{'name': 'Relegation', 'number': -1}",0,ddlwlwlwwlllddddwlwldlllddwdlllddl
21,4492,20,12,32,19,32,33,51,-19,7,1,8,5,4,9,12,17,5,34,Villarreal CF II,,Villarreal II,villarreal-cf-ii,/clubs/villarreal-cf-ii-4492,/clubs/villarreal-cf-ii-4492,/clubs/villarreal-cf-ii-4492,/clubs/villarreal-cf-ii-4492,22,"{'name': 'Relegation', 'number': -1}",0,lwllddwddwllllwdlwlwdlldlwddlllllw
